111111111111111
1P000000000C001
100111111111001
100100000000001
100101111111101
1C0100000C00001
100101111111101
100100000000001
100111111111001
100000000000E01
111111111111111