111111
1P0111
111111
111C11
111E11
111111