1111111
1P0X0E1
1C00001
1111111