1111111
1P0C0E1
100P001
1111111