1111111111
1P000C0001
1011011101
1000000C01
10110110E1
1C00000001
1111111111